    中外运股份有限公司		希杰荣庆物流供应链有限公司
	中远海运物流有限公司		华瑞物流股份有限公司
	顺丰控股股份有限公司		点我达网络科技有限公司
	中国石油天然气运输公司		东方海外物流(中国)有限公司
	冀中能源国际物流集团有限公司		正本物流有限公司
	青岛日日顺物流有限公司		上海郑明现代物流有限公司
	圆通速递有限公司		江苏金陵交运集团有限公司
	远成物流股份有限公司		北京福田智科物流有限公司
	申通快递股份有限公司		运满满
	锦程国际物流集团股份有限公司		锦海捷亚国际货运有限公司
	招商局能源运输股份有限公司		郑州交通运输集团有限责任公司
	中通快递股份有限公司		上海山汉国际物流有限公司
	韵达控股股份有限公司		贵阳货车帮科技有限公司
	重庆长安民生物流股份有限公司		四川长虹民生物流股份有限公司
	建发物流集团有限公司		深圳正佳物流有限公司
	京东物流		上海交运日红国际物流有限公司
	菜鸟网络科技有限公司		深圳市普路通供应链管理股份有限公司
	嘉里大通物流有限公司		深圳市森华物流有限公司
	振华物流集团有限公司		山东京博物流股份有限公司
	河北省物流产业集团有限公司		成都市蚂蚁物流有限公司
	中国新兴交通物流总公司		漯河双汇物流投资有限公司
	重庆港务物流集团有限公司		天津港物流发展有限公司
	德邦物流股份有限公司		福建八方物流股份有限公司
	上港集团物流有限公司		安徽江汽物流有限公司
	深圳市飞马国际供应链股份有限公司		达升物流股份有限公司
	北京长久物流股份有限公司		上海荣庆物流有限公司
	上海安能聚创供应链管理有限公司		江苏新宁现代物流股份有限公司
	厦门国贸泰达物流有限公司		江苏苏汽国际物流集团有限公司
	安得物流股份有限公司		上海领鲜物流有限公司
	厦门象屿速传供应链发展股份有限公司		新杰物流集团股份有限公司
	中铁铁龙集装箱物流股份有限公司		江苏华晓医药物流有限公司
	上海交运股份有限公司		上海天地汇供应链管理有限公司
	新疆哈密广汇物流有限公司		河南鲜易供应链有限公司
	港中旅华贸国际物流股份有限公司		天津德利得供应链管理股份有限公司
	江苏苏宁物流有限公司		上海青旅国际货运有限公司
	浙江百世物流科技有限公司		沧州运输集团股份公司
	宁波海运股份有限公司		北京京粮物流有限公司
	海南海峡航运股份有限公司		许昌众荣冷链物流有限公司
	江苏萬林现代物流股份有限公司		唯凯国际物流股份有限公司
	深圳市华鹏飞现代物流股份有限公司		江苏飞力达国际物流股份有限公司
	渤海轮渡股份有限公司		上海美设国际货运有限公司
	今天国际物流技术股份有限公司		湖南一力股份有限公司
	林森物流集团有限公司		恒通物流股份有限公司
	四川安吉物流集团有限公司		浙江省八达物流有限公司
	中创物流股份有限公司		福建万集物流有限公司
	上海佳吉快运有限公司		珠海恒基达鑫国际化工仓储股份有限公司
	中国厦门外轮代理有限公司		达达配送
	盛丰物流集团有限公司		福建省宏捷物流有限公司
	盛辉物流集团有限公司		河北新武安钢铁集团物流有限公司
	天津五八到家生活服务有限公司		人人快送